1 0 1 0 1 1 0 1 0 1 
0 1 0 0 0 0 0 1 0 0 
1 0 0 1 0 1 1 0 0 1 
1 1 0 1 1 0 0 1 0 0 
0 0 1 0 0 0 1 0 1 1 
1 0 0 0 1 0 0 0 0 0 
0 0 1 1 0 1 1 1 0 1 
1 0 0 0 0 0 0 0 1 0 
0 0 1 0 1 0 1 0 0 0 
1 0 0 0 0 0 1 0 1 0 
Runes: 
3, 0
Orbs: 
9, 3
