1 0 1 1 0 0 1 0 1 0 
0 0 0 0 1 0 0 0 0 0 
1 0 1 1 0 1 0 1 0 1 
0 0 0 0 1 0 0 0 0 0 
0 1 0 1 0 1 1 0 1 0 
0 0 0 0 0 0 0 0 0 0 
1 0 1 0 1 0 1 0 1 0 
0 0 0 0 0 0 0 0 0 0 
1 0 1 0 1 0 1 0 1 0 
0 0 0 0 0 0 0 0 1 0 
Runes: 
3, 5
Orbs: 
7, 1
