1 1 0 1 0 1 0 1 0 1 
0 0 0 0 0 0 0 0 0 0 
1 0 1 0 1 0 1 0 1 0 
1 0 0 0 0 0 1 0 0 0 
0 1 1 0 1 0 0 0 1 0 
0 1 0 0 1 0 1 0 0 0 
0 0 0 1 0 0 0 1 1 0 
1 1 0 0 0 1 0 1 0 0 
0 0 1 1 0 0 0 0 0 1 
1 0 0 1 0 1 0 1 0 0 
Runes: 
2, 6
Orbs: 
9, 1
